OOOOOOOOOO
OxO x  O O
OX. OO   O
O OxO    O
O OOOO O.O
O O O    U
O OOOOOO.O
O O      O
O O OOOOOO
O . O    O
OOOOOOOOOO
