OOOOOOOOOOOOOOOOOOOOOOOOOUOOOOO
O       O                     O
OOOOOOO O OOOOOOOOOOOOOOOOOOO O
O     O O O   O         O   O O
OOO OOO O O O OOO OOOOO O O O O
O   O   O O O   O O       O O O
O O O OOO O OOO O O OOOOOOOOO O
O O O   O O   O   O O O     O O
O O OOO O OOO OOOOO O O OOO O O
O O   O   O   O   O   O O O   O
O OOO OOOOO OOO O OOO O O OOOOO
O   O     O   O O   O O   O   O
OOO OOOOO OOO O OOO O OOO O OOO
O   O         O O O O   O O   O
O OOOOOOOOOOOOO O O OOO O OOO O
O     O     O O   O   O O   O O
OOOOO O OOO O OOO O OOO OOO O O
O   O   O   O   O O   O   O   O
O O OOOOO OOOOO O OOO OOO OOO O
OOOOOOOOOOOOOOOOOOOOOOOOOOOOOOO
